######################################+++++++++#################################
#++++++++++++++++++++++++++++++++++++++++++++++++++++++++++++++++++++++++++++++#
#++++++++++++++++++++++++++++++++++++++++++++++++++++++++++++++++++++++++++++++#
#++++++++++++++++++++++++++++++++++++++++++++++++++++++++++++++++++++++++++++++#
#++++++++++++++++++++++++++++++++++++++++++++++++++++++++++++++++++++++++++++++#
#++++++++++++++++++++++++#+++++++++++++++++++++++++++++++++++++++++++++++++++++#
#+++++++++#++++++++++++++++++++++++++++++++++++++++++++++++++++++++++++++++++++#
#++++++++++++++++++++++++++++++++++++++++++++++++++++++++++++++++++++++++++++++#
#+++++++++++++++++++++##+++++++++++++++++++++++++++++++++++++++++++++++++++++++#
#+++++++++++++++++++++##+++++++++++++++++++++++++++++++++++++++++#+++++++++++++#
#++++++++++++++++++++++++++++++++++++++++++++++++++++++++++++++++#+++++++++++++#
###############################++++++++++++++++++++++++++++++++++++++++++++++++#
#++++++++++++++++++++++++++++++++++++++++++++++++++++++++++++++++#+++++++++++++#
#++++++++++++++++++++++++++++++++++++++++++++++++++++++++++++++++#+++++++++++++#
#++++++++++++++++++++++++++++++++++++++++++++++++++++++++++++++++#+++++++++++++#
#++++++++++++++++++++++++++++++++++++++++++++++++++++++++++++++++#+++++++++++++#
#++++++++++++++++++++++++++++++++++++++++++++++++++++++++++++++++#+++++++++++++#
#++++++++++++++++++++++++++++++++++++++++++++++++++++++++++++++++#++++++++++++++
################++++++####################+++###################################
################++++++####################+++###################################