######################################+++++++++#############################
#+++++++++++++++++++++++++++++++++++##+++++++++++++++++++++++++++++++++++++#
#+++++++++++++++++++++++++++++++++++##+++++++++++++++++++++++++++++++++++++#
#+++++++++++++++++++++++++++++++++++##+++++++++++++++++++++++++++++++++++++#
#+++++++++++++++++++++++++++++++++++##+++++++++++++++++++++++++++++++++++++#
#++++++++++++++++++++++++#++++++++++##+++++++++++++++++++++++++++++++++++++#
#+++++++++#+++++++++++++++++++++++++##+++++++++++++++++++++++++++++++++++++#
#+++++++++++++++++++++++++++++++++++##++++++++++++++++++++++++++++++++++++++
##+++++++++++++++++++###+++++++++++++++++++++++++++++++++++++++++++++++++++#
##++++++++++++++++++++###++++++++++++++++++++++++++++++++++++++++#+++++++++#
#########++++++++++++++++++++++++++++++++++++++++++++++++++++++++#+++++++++#
#++++++++++++++++++++++++++++++++++++++++++++++++++++++++++++++++#+++++++++#
#++++++++++++++++++++++++++++++++++++++++++++++++++++++++++++++++#+++++++++#
#++++++++++++++++++++++++++++++++++++++++++++++++++++++++++++++++#+++++++++#
#++++++++++++++++++++++++++++++++++++++++++++++++++++++++++++++++#+++++++++#
#++++++++++++++++++++++++++++++++++++++++++++++++++++++++++++++++#+++++++++#
#++++++++++++++++++++++++++++++++++++++++++++++++++++++++++++++++#+++++++++#
#++++++++++++++++++++++++++++++++++++++++++++++++++++++++++++++++#+++++++++#
##########################################+++###############################
##########################################+++###############################